F 189,180,170
C 45,71,87


SO Sprites/TECH_0E1685546519.xpm
NO Sprites/TECH_0E1685546519.xpm

WE Sprites/TECH_0E1685546519.xpm
EA Sprites/TECH_0E1685546519.xpm






        1111111111111111111111111
        1000000000110000000000001
        1011000001110000000000001
        1001000000000000000000001
111111111011000001110000000000001
100000000011000001110111111011111
11110111111111011100000010001
11110111111111011101010010001
10100000110101011100000010001
11000000000000001100000010001
10100000000000001101010010001
11000001110101011111011110E0011
11110111 1110101 101111010001
11111111 1111111 11111111111