1111T11
10ED001
1001001
1000001
1111111
 
1111
10D01
1111