        1111111111111111111111111
        1000000000110000000000001
        1011000001110000000000001
        100D000000D00000000000001
111111111011000001110000000000001
100000000011000001110111111011111
11110111111111D1T1000000111D1
1111D1111111110111010100100N1
1100000011010101110000001000T
10000000000000001100000010001
10000000000000000001010010001
1100000T1101010111110111100011
11110111 1110101 101111010001
11111111 1111111 111111111111
 
11111
10D0T
11111