11111111111111111111111111111111111111111111111111111111111111
1000000001101000000000000000000D000000000000000000000000000001
1000000001001000000000000T000001000000000000000000000000000001
100000000101100000000000T1T0000T000000000000000001111111000001
1000000001010000000000000T000001000000000000000010000000100001
10000000010100000000000000000001000000000000000001000001000001
10000000010100000001111111111111110000000000000000100001000001
1000000001010000000100000000000001000000000000000001D1T0000001
10000000010100000001000000000000010000000000000000000000000001
100000000101000000010000001111D1111110000000000000000000000001
10111111110111111111000000100000000010111100111111001111111111
100000000000000000000000001000000000T0000000000000001
100000000000000000000000001000N0000010000000000000001
10010000000000000000000000100000000010000000000010001
10010000000001111111T11111100000000010000000000010001
1001000000000D000000000000100000000010000000000010001
100111111111110000000000001111111111T1110000T00000001111111111
10000000100000000000000000000000000000000000000000111000000001
1000000010000000000000000000000000000000000000001100000000001
100000001000000000000000000000000000000000000000T0000000000001
1000000010000000000000000000000000000000000001D11000000000001
1000000010000000000000000000000000011D111111100000000000000001
10000000100000000000000000000000000D00000001 1000000000000001
11111000T0000000000000000000000000011D100001  11000000000001
    1000100000000000000000000000000010000001    1000000000001
    111111111111111111111111111111111111T111     1111111111111