F 220,100,0
C 225,30,0


SO Wall/wall_0.xpm
NO Wall/wall_0.xpm

WE Wall/wall_0.xpm
EA Wall/wall_0.xpm

1111
10011
101N01
11111